5;5;5;5;5;5;5;5;5;5;5;5;5;5;5;5;5;5;5;5;5;5;5;5
5;3;3;3;3;3;3;3;3;3;3;5;5;3;3;3;3;3;3;3;3;3;3;5
5;3;5;5;5;3;5;5;5;5;3;5;5;3;5;5;5;5;3;5;5;5;3;5
5;4;5;2;5;3;5;2;2;5;3;5;5;3;5;2;2;5;3;5;2;5;4;5
5;3;5;5;5;3;5;5;5;5;3;5;5;3;5;5;5;5;3;5;5;5;3;5
5;3;3;3;3;3;3;3;3;3;3;3;3;3;3;3;3;3;3;3;3;3;3;5
5;3;5;5;5;3;5;5;3;5;5;5;5;5;5;3;5;5;3;5;5;5;3;5
5;3;5;5;5;3;5;5;3;5;5;5;5;5;5;3;5;5;3;5;5;5;3;5
5;3;3;3;3;3;5;5;3;3;3;5;5;3;3;3;5;5;3;3;3;3;3;5
5;5;5;5;5;3;5;5;5;5;2;5;5;2;5;5;5;5;3;5;5;5;5;5
5;2;2;2;5;3;5;5;5;5;2;5;5;2;5;5;5;5;3;5;2;2;2;5
5;2;2;2;5;3;5;5;2;2;2;2;2;2;2;2;5;5;3;5;2;2;2;5
5;2;2;2;5;3;5;5;2;5;5;2;2;5;5;2;5;5;3;5;2;2;2;5
5;5;5;5;5;3;5;5;2;5;2;2;2;2;5;2;5;5;3;5;5;5;5;5
2;2;2;2;2;3;2;2;2;5;2;2;2;2;5;2;2;2;3;2;2;2;2;2
5;5;5;5;5;3;5;5;2;5;2;2;2;2;5;2;5;5;3;5;5;5;5;5
5;2;2;2;5;3;5;5;2;5;5;5;5;5;5;2;5;5;3;5;2;2;2;5
5;2;2;2;5;3;5;5;2;2;2;2;2;2;2;2;5;5;3;5;2;2;2;5
5;2;2;2;5;3;5;5;2;5;5;5;5;5;5;2;5;5;3;5;2;2;2;5
5;5;5;5;5;3;5;5;2;5;5;5;5;5;5;2;5;5;3;5;5;5;5;5
5;3;3;3;3;3;3;3;3;3;3;5;5;3;3;3;3;3;3;3;3;3;3;5
5;3;5;5;5;3;5;5;5;5;3;5;5;3;5;5;5;5;3;5;5;5;3;5
5;3;5;5;5;3;5;5;5;5;3;5;5;3;5;5;5;5;3;5;5;5;3;5
5;4;3;5;5;3;3;3;3;3;3;3;3;3;3;3;3;3;3;5;5;3;4;5
5;5;3;5;5;3;5;5;3;5;5;5;5;5;5;3;5;5;3;5;5;3;5;5
5;5;3;5;5;3;5;5;3;5;5;5;5;5;5;3;5;5;3;5;5;3;5;5
5;3;3;3;3;3;5;5;3;3;3;5;5;3;3;3;5;5;3;3;3;3;3;5
5;3;5;5;5;5;5;5;5;5;3;5;5;3;5;5;5;5;5;5;5;5;3;5
5;3;5;5;5;5;5;5;5;5;3;5;5;3;5;5;5;5;5;5;5;5;3;5
5;3;3;3;3;3;3;3;3;3;3;3;3;3;3;3;3;3;3;3;3;3;3;5
5;5;5;5;5;5;5;5;5;5;5;5;5;5;5;5;5;5;5;5;5;5;5;5
